être	sein
ou	oder
où	wo
un	ein	eine	einen	einer	
j'ai	ich habe
dans	in	
le	der	die	das	dem	
nord	Norden	
de	von		von den
la	der	die	das	dem	
france	Frankreich	
librairie	Buchhandlung	
furet	Spürnase	Frettchen	
du	des	von dem	
est	ist	Osten	
une	ein	eine	einen	einer	
institution	Institution	
marché		Markt
livre		Buch
zone		Zone
turbulence		Turbulenz
alors	obwohl
que	(dass)
traverse	durchquert
l'enseigne	das Unternehmen
ne	nicht
cesse	aufhört
se	sich
développer	entwickeln
coup	Schuss
projecteur	Scheinwerfer
sur	auf
succès	Erfolg
ch'ti	(Ch'ti)
les	die
gens	Leute	Menschen
liraient	würden lesen
plus	mehr
aurait	hätte
été	gewesen
remplacé	ersetzt
par	durch
séries	Serien
télévisées	Fernseh-
boutiques	Läden
amazon	(Amazon)
à	zu
en	daran	in
croire	glauben
certains	einigen
pas	(nicht)
bonne	gute
santé	Gesundheit
sont	sind
institutions	Institutionen
ce	dies
véritables	wirklichen
ils	sie
au	an
nombre	Anzahl
plutôt	eher
bon	gut
disons	sagen wir
dictionnaires	Wörterbücher
représente	repräsentiert
on	man
peut	kann
conseiller	beraten
père	Vater
qui	der
veut	will
acheter	kaufen
pour	für
son	sein	Sein
enfant	Kind
faire	machen
explique	erklärt
pierre	Peter
coursières	(Coursières)
rencontre	treffen
chez	mit
nous	wir
tout	all
dictionnaire	Wörterbuch
secret	Geheimnis
